EA textures/East.xpm
SO textures/South.xpm
NO textures/North.xpm
WE textures/West.xpm

C 16,16,16
F 88,57,39


        1111111111111111111111111
        1000000000110000000000001
        1011000001110000000000001
        1011000000000000000000001
111111111011000001110000000000001
100000000000000001111111111111111
11110111111111111111111111111
11110111111111111100000000001
11110111111111111100000010001
11000000111111111101000010001
10000000000000001101000010001
10000000000000000001000010001
111111111111111111111111100N1
                        11111