1111111111111111111111111
1C00000000010C00000000001
1001110010010000000000001
1001110010011111000001001
0000000010000000000001001
1P0000001000000C0000010E1
1111111111111111111111111