1111111111111
1111C00000001
1110011111001
1P0011E001001
1111111111111
