1111111111111
1111C000000C1
1110011111001
1P0011C00E0C1
1111111111111
