1111111111111111111111111
1C000P0000C10C00000C00001
1001110010010000000000001
100111C01001111100C111101
1000000010C00000000111101
1C0000C01000000C0001E0001
1111111111111111111111111