1111111111111
1111C00C000C1
1110011111000
1P0011E00C0C1
1111111111111